Id,Label,size,modularity_class,indegree,outdegree,Degree,weighted indegree,weighted outdegree,Weighted Degree,Size
KRPrus52,–ö–†–ü - –ù–∏–∂–Ω–∏–π –ù–æ–≤–≥–æ—Ä–æ–¥,78,1,0,3,3,0,4,4,3
nazbol_sar,–î—Ä—É–≥–æ–π –°–∞—Ä–∞–Ω—Å–∫,139,1,20,4,24,446,45,491,3.000643
inter_manufactory_77,–¶–ï–• 77,239,1,0,15,15,0,137,137,3.001696
drugoros_vrn,–î—Ä—É–≥–æ–π –í–æ—Ä–æ–Ω–µ–∂,321,1,8,10,18,34,69,103,3.00256
uralpartisan,–£—Ä–∞–ª—å—Å–∫–∏–π –ü–∞—Ä—Ç–∏Z–∞–Ω,373,1,13,10,23,48,86,134,3.003108
dr_kuban,–î—Ä—É–≥–∞—è –ö—É–±–∞–Ω—å,382,1,13,12,25,174,153,327,3.003203
fabric80,–¶–µ—Ö80,394,1,2,16,18,4,107,111,3.003329
nbstaroverov,–ë–µ—Å–ø–µ—á–Ω—ã–π –ø–ª–æ—Ç–Ω–∏–∫ Z,687,1,30,18,48,490,227,717,3.006416
molotov_perm,–ú–æ–ª–æ—Ç–æ–≤!,929,1,24,15,39,810,430,1240,3.008966
Protoinquisitor,–°—É–¥—å—è –∏–Ω–∫–≤–∏–∑–∏—Ü–∏–∏,1178,4,2,4,6,8,63,71,3.011589
igorvezite,–¶–µ—Ö52,1286,1,6,7,13,110,88,198,3.012727
heartlandfire,–•–∞—Ä—Ç–ª–µ–Ω–¥,1539,0,17,6,23,46,10,56,3.015392
bunkerdayly,#–±—É–¥–Ω–∏–ë—É–Ω–∫–µ—Ä–∞‚ö°Ô∏èZ,1542,1,34,23,57,1413,818,2231,3.015424
RDS_official_smi,–†—É—Å—Å–∫–∏–π –ú–∞–Ω–∏—Ñ–µ—Å—Ç | –ü—Ä–µ—Å—Å–∞ –†–î–°,1889,4,46,4,50,1228,161,1389,3.01908
boris975,–ë–æ—Ä–∏—Å –ú—ã—à–ª—è–≤—Ü–µ–≤,1985,4,3,3,6,11,15,26,3.020091
ImashevNB,–£—Ä–∞–ª—å—Å–∫–∏–π –ø—Ä–∏—â—É—Ä Z –ö–∏—Ä–∏–ª–ª –ò–º–∞—à–µ–≤,2056,1,37,19,56,625,314,939,3.020839
new_totalis,Totalis,2496,1,45,19,64,1567,232,1799,3.025475
rossia_3,–ï–°–ú | –†–û–°–°–ò–Ø-Z,2647,0,38,12,50,626,228,854,3.027066
zverochan,ZV–µ—Ä—Å—Ç–≤–∞ –∏ —Ç–û—á–∫–∞. –°–≤–æ–±–æ–¥—É –õ–µ–Ω–µ –ï–≥–æ—Ä–æ–≤–æ–π.,2784,1,30,4,34,176,24,200,3.028509
rusjuche,–†—É—Å—Å–∫–æ–µ —á—É—á—Ö–µ,2798,1,36,24,60,699,791,1490,3.028656
mihailaksel,–ú–∏—Ö–∞–∏–ª –ê–∫—Å–µ–ª—å,3392,1,32,23,55,692,305,997,3.034914
drugoros_spb,–õ–ï–ù–ò–ù–ì–†–ò–ë üÖâ (–Ω–∞—Ü–±–æ–ª—ã),3451,1,20,28,48,523,883,1406,3.035536
imperskiylegion1917,–ò–º–ø–µ—Ä—Å–∫–∏–π –ª–µ–≥–∏–æ–Ω,3505,3,4,4,8,22,104,126,3.036105
Rus_imperia,–†—É—Å—Å–∫–æ–µ –ò–º–ø–µ—Ä—Å–∫–æ–µ –î–≤–∏–∂–µ–Ω–∏–µ,3864,3,39,8,47,495,45,540,3.039887
zapiskitrad,Z–∞–ø–∏—Å–∫–∏ —Ç—Ä–∞–¥–∏—Ü–∏–æ–Ω–∞–ª–∏—Å—Ç–∞,5169,0,10,5,15,70,149,219,3.053636
interbrigady2022,–ò–Ω—Ç–µ—Ä–±—Ä–∏–≥–∞–¥—ã 2022,6134,1,33,33,66,681,1495,2176,3.063803
chernaya100kitchen,–ö—É—Ö–Ω—è —á–µ—Ä–Ω–æ—Å–æ—Ç–µ–Ω—Ü–∞,6806,4,11,21,32,77,101,178,3.070883
RDS_Official_channel,–†–î–°. –†–£–°–°–ö–û–ï –î–í–ò–ñ–ï–ù–ò–ï –°–¢–†–ï–õ–ö–û–í–ê,7494,4,31,9,40,1138,664,1802,3.078131
russdiary,–†–£–°–°–ö–ò–ô –î–ù–ï–í–ù–ò–ö,8395,0,18,7,25,82,20,102,3.087624
R_Vestovoi,–í—£—Å—Ç–æ–≤–æ–π üá∑üá∫,10932,4,2,11,13,3,152,155,3.114352
georgy_fedorov,–§–µ–¥–æ—Ä–æ–≤ –ó–¥–æ—Ä–æ–≤–æ–≥–æ –ß–µ–ª–æ–≤–µ–∫–∞,12289,4,7,14,21,21,264,285,3.128649
adirect,–ü—Ä—è–º–æ–µ –¥–µ–π—Å—Ç–≤–∏–µ‚ö°Z,12949,1,47,38,85,2643,4216,6859,3.135602
der_kultur_kampf,–ö—É–ª—å—Ç—É—Ä–Ω–∞—è –≤–æ–π–Ω–∞ | Kulturkampf,13126,1,4,8,12,10,16,26,3.137467
juchkovsky,–ê–ª–µ–∫—Å–∞–Ω–¥—Ä –ñ—É—á–∫–æ–≤—Å–∫–∏–π,13716,4,30,25,55,257,248,505,3.143683
KRPRus,–ö–ª—É–± —Ä–∞—Å—Å–µ—Ä–∂–µ–Ω–Ω—ã—Ö –ø–∞—Ç—Ä–∏–æ—Ç–æ–≤,14403,1,18,14,32,75,85,160,3.150921
rus_jansen,–Ø–Ω—Å–µ–Ω | Z,14837,4,22,17,39,87,46,133,3.155493
russia_and_anvil,–°–∞–≤–≤–∞ –§–µ–¥–æ—Å–µ–µ–≤,15946,1,22,27,49,83,176,259,3.167177
tsarkrest,–î–í–ò–ñ–ï–ù–ò–ï –¶–ê–†–°–ö–ò–ô –ö–†–ï–°–¢,20908,3,34,14,48,282,390,672,3.219454
Andrafanaslive,–ê—Ñ–∞–Ω–∞—Å—å–µ–≤ Z,21842,3,29,29,58,1176,792,1968,3.229294
comradepelevin,–ê–ª–µ–∫—Å–∞–Ω–¥—Ä –ü–µ–ª–µ–≤–∏–Ω Z,22729,1,24,25,49,232,348,580,3.238639
kartezianec,Cogito ergo sum (–∫–∞–Ω–∞–ª –∞—Ä—Ö–∏–µ–ø–∏—Å–∫–æ–ø–∞ –°–∞–≤–≤—ã),23716,3,13,21,34,142,432,574,3.249038
nwindpro,–°–µ–≤–µ—Ä–Ω—ã–π –≤–µ—Ç–µ—Ä,24015,4,4,10,14,6,61,67,3.252187
zogrussia1,ZOG 2.0,26617,5,5,3,8,13,5,18,3.279601
pgubarev,–†—è–¥–æ–≤–æ–π –ì—É–±–∞—Ä–µ–≤,31872,4,22,21,43,116,124,240,3.334965
soldat_prav,–°–û–õ–î–ê–¢–°–ö–ê–Ø –ü–†–ê–í–î–ê,36764,4,38,18,56,802,974,1776,3.386504
ordinaryczarizm,–û–±—ã–∫–Ω–æ–≤–µ–Ω–Ω—ã–π —Ü–∞—Ä–∏–∑–º,37892,1,5,32,37,6,228,234,3.398388
blackcolonel2020,"""–ß–µ—Ä–Ω—ã–π –ø–æ–ª–∫–æ–≤–Ω–∏–∫"" –í.–ê–ª–∫—Å–Ω–∏—Å",41046,4,6,12,18,9,172,181,3.431617
rusfleet,–ó–∞–ø–∏—Å–∫–∏ –º–∏—á–º–∞–Ω–∞ –ü—Ç–∏—á–∫–∏–Ω–∞,53568,4,20,33,53,126,208,334,3.563542
i_strelkov_2023,–ú–∏—Ä–æ—Å–ª–∞–≤–∞ –†–µ–≥–∏–Ω—Å–∫–∞—è (–°–≤–æ–±–æ–¥—É –°—Ç—Ä–µ–ª–∫–æ–≤—É!),57589,4,13,27,40,39,782,821,3.605905
Agdchan,AGDchan,71403,0,30,24,54,995,376,1371,3.751442
spastv,–¢–µ–ª–µ–∫–∞–Ω–∞–ª –°–ü–ê–°,73771,3,13,14,27,1343,673,2016,3.77639
romagolovanov,–ì–û–õ–û–í–ê–ù–û–í,83927,3,24,23,47,568,578,1146,3.883389
beard_tim,–°–∏–Ω—è—è Z –ë–æ—Ä–æ–¥–∞,99116,1,51,32,83,1242,499,1741,4.043412
zhivoff,–ñ–ò–í–û–í Z,117041,5,41,31,72,637,295,932,4.23226
boriskorchevnikov,–ë–æ—Ä–∏—Å –ö–æ—Ä—á–µ–≤–Ω–∏–∫–æ–≤,120690,3,14,16,30,397,990,1387,4.270704
o_andrey_tkachev,–ê–ù–î–†–ï–ô –¢–ö–ê–ß–Å–í,127639,3,18,13,31,44,102,146,4.343915
brussinf,–ü–æ–∑—ã–≤–Ω–æ–π –ë—Ä—é—Å,136023,5,14,22,36,281,488,769,4.432244
Alekhin_Telega,–†–æ–º–∞–Ω –ê–ª–µ—Ö–∏–Ω,188824,5,13,24,37,133,443,576,4.988527
ghost_of_novorossia,–ü—Ä–∏Z—Ä–∞–∫ –ù–æ–≤–æ—Ä–æ—Å—Å–∏–∏,199441,4,39,37,76,1242,765,2007,5.100383
RtrDonetsk,–†–µ–ø–æ—Ä—Ç—ë—Ä –†—É–¥–µ–Ω–∫–æ V,232094,5,16,27,43,538,653,1191,5.444397
vladlentatarsky,–í–ª–∞–¥–ª–µ–Ω –¢–∞—Ç–∞—Ä—Å–∫–∏–π,255094,5,34,43,77,1260,1412,2672,5.686713
infantmilitario,–ú–∏–ª–∏—Ç–∞—Ä–∏—Å—Ç,286187,5,7,24,31,23,444,467,6.014293
notes_veterans,Z–ê–ü–ò–°–ö–ò V–ï–¢–ï–†–ê–ù–ê,358596,4,32,41,73,654,921,1575,6.777155
voenkorKotenok,–í–æ–µ–Ω–∫–æ—Ä –ö–æ—Ç–µ–Ω–æ–∫,408401,5,38,44,82,2180,646,2826,7.301874
strelkovii,–°—Ç—Ä–µ–ª–∫–æ–≤ –ò–≥–æ—Ä—å –ò–≤–∞–Ω–æ–≤–∏—á,433253,4,27,33,60,600,302,902,7.563702
aleksandr_skif,–ê–ª–µ–∫—Å–∞–Ω–¥—Ä –•–æ–¥–∞–∫–æ–≤—Å–∫–∏–π,499631,5,5,30,35,16,590,606,8.263025
grey_zone,GREY ZONE,547227,5,0,7,7,0,12,12,8.764471
obshina_ru,–†—É—Å—Å–∫–∞—è –û–±—â–∏–Ω–∞ ZOV,616283,3,26,19,45,428,324,752,9.492008
sashakots,Kotsnews,621646,5,30,49,79,2225,3605,5830,9.54851
kvmalofeev,–ö–æ–Ω—Å—Ç–∞–Ω—Ç–∏–Ω –ú–∞–ª–æ—Ñ–µ–µ–≤,743128,0,2,15,17,13,453,466,10.82838
epoddubny,–ü–æ–¥–¥—É–±–Ω—ã–π |Z|–û|V| edition,770819,5,22,35,57,1950,1608,3558,11.120117
voenacher,–ü–æ–≤—ë—Ä–Ω—É—Ç—ã–µ –Ω–∞ –≤–æ–π–Ω–µ üá∑üá∫,791544,5,26,35,61,2655,901,3556,11.338465
Sladkov_plus,–°–ª–∞–¥–∫–æ–≤+,919739,5,9,36,45,213,645,858,12.689059
wargonzo,WarGonzo,1032159,5,28,42,70,700,1577,2277,13.873457
dva_majors,–î–≤–∞ –º–∞–π–æ—Ä–∞,1178426,5,22,31,53,1503,1036,2539,15.414448
rusich_army,–ê–†–•–ê–ù–ì–ï–õ –°–ü–ï–¶–ù–ê–ó–ê Züá∑üá∫,1179493,5,13,24,37,133,1503,1636,15.425689
rybar,–†—ã–±–∞—Ä—å,1315743,5,27,36,63,2398,3294,5692,16.861147
RVvoenkor,–û–ø–µ—Ä–∞—Ü–∏—è Z: –í–æ–µ–Ω–∫–æ—Ä—ã –†—É—Å—Å–∫–æ–π –í–µ—Å–Ω—ã,1613675,5,20,36,56,200,372,572,20
